R 800 500
NO ./srcs/textures/redbrick.xpm
EA                                   ./srcs/textures/mossy.xpm
SO        ./srcs/textures/greystone.xpm
WE                    ./srcs/textures/wood.xpm
S   ./srcs/textures/pillar.xpm
C             255, 0   ,   0    
F        0 ,  0,  255
                                                         1111111
                                                        11020111111111
                1111111111111111                       11000000000001
                100000000000000011111111111111111111111111020020020021
                102000002000002000000000000000000000000000000000000001
                100000000000000011111111111111111001111111111111011111
                10002000200020001               1001           101
                10000000000000001               1001           101111111111111111
                10202020002020201               1001           100000000000000001
                10000000000000001           111110011111       111111111111111101
                10002000200200001           100000000001                      101
                10000000000000001           100000000001                      101
                10200000200002001111111111111000200200011111111111111111111111101
                10000000000000000000000000000000000000000000000000000000000000001
                11111011111111111111111111111000200200011111111111111111111111101
                    101                     100000000001                      101
                11111011111111111           100000000001                      101
                10000000000000001           111110011111                      101
                10200000200000201               1001                          101
                10000000000000001111111111111111100111111111111111111111111111101
                10002000200020000000N00000000000000000000000000000000000000000001
                1000000000000000111111111111111111111111111111111111111111111111
                10202020002020201
                10000000000000001
                10002000200200001
                10000000000000001
                10200000200002001111111111111
                10000000000000000000000000001
                11111111111111111111111111101
                                         11011
                                        11000111111111
11111111111111111                       11000000000001
100000000000000011111111111111111111111111020020020021
102000002000002000000000000000000000000000000000000001
100000000000000011111111111111111001111111111111011111
10002000200020001               1001           101
10000000000000001               1001           101111111111111111
10202020002020201               1001           100000000000000001
10000000000000001           111110011111       111111111111111101
10002000200200001           100000000001                      101
10000000000000001           100000000001                      101
10200000200002001111111111111000200200011111111111111111111111101111111111111111111111111111111111111111111111111111111111111111111111111111111111111111111111111111111
10000000000000000000000000000000000000000000000000000000000000000000000000000000000000000000000000000000000000000000000000000000000000000000000000000000000000000000001
11111011111111111111111111111000200200011111111111111111111111101111111111111111111111111111111111111111111111111111111111111111111111111111111111111111111111111111111
    101                     100000000001                      101
11111011111111111           100000000001                      101
10000000000000001           111110011111                      101
10200000200000201               1001                          101
10000000000000001111111111111111100111111111111111111111111111101
10002000200020000000000000000000000000000000000000000000000000001
10000000000000001111111111111111111111111111111111111111111111111
10202020002020201
10000000000000001
10002000200200001
10000000000000001
102000002000020011111111111111111111111111111111111111111111
100000000000000000000000000000000000000000000000000000000001
111111111111111111111111111111111111111111111111111111111101
                                                        110111
                                                        11020111111111
                11111111111111111                       11000000000001
                100000000000000011111111111111111111111111020020020021
                102000002000002000000000000000000000000000000000000001
                100000000000000011111111111111111001111111111111011111
                10002000200020001               1001           101
                10000000000000001               1001           101111111111111111
                10202020002020201               1001           100000000000000001
                10000000000000001           111110011111       111111111111111101
                10002000200200001           100000000001                      101
                10000000000000001           100000000001                      101
                10200000200002001111111111111000200200011111111111111111111111101
                10000000000000000000000000000000000000000000000000000000000000001
                11111011111111111111111111111000200200011111111111111111111111101
                    101                     100000000001                      101
                11111011111111111           100000000001                      101
                10000000000000001           111110011111                      101
                10200000200000201               1001                          101
                10000000000000001111111111111111100111111111111111111111111111101
                10002000200020000000000000000000000000000000000000000000000000001
                10000000000000001111111111111111111111111111111111111111111111111
                10202020002020201
                10000000000000001
                10002000200200001
                10000000000000001
                10200000200002001111111111111
                10000000000000000000000000001
                11111111111111111111111111101
                                         11011
                                        11000111111111
11111111111111111                       11000000000001
100000000000000011111111111111111111111111020020020021
102000002000002000000000000000000000000000000000000001
100000000000000011111111111111111001111111111111011111
10002000200020001               1001           101
10000000000000001               1001           101111111111111111
10202020002020201               1001           100000000000000001
10000000000000001           111110011111       111111111111111101
10002000200200001           100000000001                      101
10000000000000001           100000000001                      101
10200000200002001111111111111000200200011111111111111111111111101111111111111111111111111111111111111111111111111111111111111111111111111111111111111111111111111111111
10000000000000000000000000000000000000000000000000000000000000000000000000000000000000000000000000000000000000000000000000000000000000000000000000000000000000000000001
11111011111111111111111111111000200200011111111111111111111111101111111111111111111111111111111111111111111111111111111111111111111111111111111111111111111111111111111
    101                     100000000001                      101
11111011111111111           100000000001                      101
10000000000000001           111110011111                      101
10200000200000201               1001                          101
10000000000000001111111111111111100111111111111111111111111111101
10002000200020000000000000000000000000000000000000000000000000001
10000000000000001111111111111111111111111111111111111111111111111
10202020002020201
10000000000000001
10002000200200001
10000000000000001
10200000200002001
10000000000000001
111111111111111111
