R 500 350
NO ./srcs/textures/colorstone.xpm
EA ./srcs/textures/greystone.xpm
SO ./srcs/textures/mossy.xpm
WE ./srcs/textures/purplestone.xpm
S ./srcs/textures/pillar.xpm
C 255,0,0
F 0,0,255

11111111111111
12000000222111
12000000000001
12000000000001
12000000000001
12000222200001
12000202000001
12000222200001
12000002000001
12000000000N01
11111111111111
