R 700 500
NO ./srcs/textures/colorstone.xpm
EA ./srcs/textures/greystone.xpm
SO ./srcs/textures/mossy.xpm
WE ./srcs/textures/purplestone.xpm
S ./srcs/textures/pillar.xpm
C 11,11,111
F 123,144,24

11111111111111
12000000222111
12000000000001
12000000000001
12000000000001
12000222200001
12000202000001
12000222200001
12000000000001
1200000N000001
1200000000000100
10000000000001111111
10000000000001
10000000000001
10000000000001
11110010100001
11111111111111

