R 300 250
NO ./srcs/textures/colorstone.xpm
EA ./srcs/textures/greystone.xpm
SO ./srcs/textures/mossy.xpm
WE ./srcs/textures/purplestone.xpm
S ./srcs/textures/pillar.xpm
C 11,11,111
F 123,144,245

111111111111111111111111
120000000000000000000021
100000000000000000000001
100000000000000000000021
1000000000S0000000000001
100000000000000000000001
120000000000000000000021
111111000002000000111111
11111100000200000001111
111110000002000000111111
11111000000200000000111
111111100011111111111111111111111111111111111
111111100000000000000000000000000000000000001
111111100000000000000000000000000000000000001
111111120211111111111111111110011111111111001
111111120211111111111111111110011111111111001
111111120211111111111111111110011111111111001
111111120211111111111111111110011111111111001
111111120211111111111111111110011111111111001
111111120211111111111111111110011111111111001
111111120211111111111111111110011111111111001
111111120211111111111111111110011111111111001
1111111202111111111111111111100111111111110011111
1111111200000000000000000000000000000000000000001
1111111000000000000000000000000000000000000000001
1111111000111111111111111111111111111111111111111
111111100011111111111
111111100011111111111
111111100011111111111
111111100011111111111
111111111111111111111

