R 600                            450
NO ./srcs/textures/colorstone.xpm
EA ./srcs/textures/greystone.xpm
SO ./srcs/textures/fuhrer.xpm
WE ./srcs/textures/purplestone.xpm
S ./srcs/textures/pillar.xpm
C 11,123,111
F 123,144,0

111111111111111111111111
120000000000000000000001
1000000000000000000000011
10000000000000N00000000021
1000000000000022200000111
1000000000000021200000001
120000000000002220000021
111111000002000000111111
1111110000020000000111100000000000000
111110000002000000111111
11111000000200000000111
111111100011111111111111111111111111111111111
111111100000000000000000000000000000000000001
111111100000000000000000000000000000000000001
111111120211111111111111111110011111111111001
111111120211111111111111111110011111111111001
111111120211111111111111111110011111111111001
111111120211111111111111111110011111111111001
111111120211111111111111111110011111111111001
111111120211111111111111111110011111111111001
111111120211111111111111111110011111111111001
111111120211111111111111111110011111111111001
1111111202111111111111111111100111111111110011111
1111111200000000000000000000000000000000000000001
1111111000000000000000000000000000000000000000001
1111111000111111111111111111111111111111111111111
111111100011111111111
111111100011111111111
111111100011111111111
112111110011111111111
11111111001111111111111
1111111111111111111111
