R 123 123
NO ./image_texture/test.xpm
SO ./image_texture/test1.xpm
WE ./image_texture/test2.xpm
EA ./image_texture/test3.xpm 
S ./image_sprite/test0.xpm 
F 25,0,254
C 1,1,1

1111111111111111111111
10000000000000001
10200000200000201
     10000000000000001
10002000200020001
10000000000000001


1020202002020201
10000000000000001
10002000200200001
1000000000000001
10200000200002001
100000000000S00001
11111111111111111
