R 1234 5678
NO ./image_texture/test.xpm               
SO ./image_tex\ ture/test1.xpm
WE ./image_texture/test2.xpm
EA ./image_texture/test3.xpm
S ./image_sprite/test0.xpm
F 111,222,255
C 0,0,0

111111
100101
102001
1100N1
111111
